####################
#B.....#....WWW....#
#......#...WWWWW...#
#....S......WWW....#
#......#...........#
#......#...S.......D
#......#...........#
#....B.#...........#
#......#...BBBBB...#
#......K...........#
####################
####################
#..................#
#..S...............#
#......B...B.......#
#...B......S.......#
#..................#
D.........S........#
#..................#
#...B......B.......#
#..........T.......#
####################
####################
#......#...........#
#....B.#...B.......#
#......#...........#
#..S...#...........#
#......#.....C.....#
#......D...........#
#......#...........#
#....B.#...........#
#......#...S.......#
####################
####################
#..................#
#....S.............#
#...BBB............#
#..................#
#...........T......#
#..................#
#......B...........#
#...S..............#
#...BBB.......B....#
#..................#
####################
