1111111111111111
1P.............1
1..111.....111.1
1..1.......1...1
1..1...2...1...1
1......2.......1
1..3...........1
1..3...........1
1......4...4...1
1..........4...1
1.....111111...1
1.....1....1...1
1.....1....X...1
1.....111111...1
1..............1
1111111111111111
