##############################################################
#P..........C.......C.............C.........C..........F####
#...........====......====..........====.....====..........##
#.......C..................E.....C...........E..............#
#...====............====............====.......................#
#..............C.........C.....C........................####
#..........====.....E..........====.....====..........######
#..C.....C...................C....................C...#######
#..==....====....====....====....====....====....===########
############################################################
############################################################
##############################################################
