MMMMMMMTTTTTTTTTTMM
MTTTTTTPTTTTTTTTTTM
MTTTTTGPTTTTGTTTTTT
MPPPPPGPGGGGGTTTGTT
TGGGGGPGGGGGGGGGGTT
TGGGGGPGGGGGGGPPPPM
TGCGGGPGGGTTGGPGGMT
TGGGGPPGGTTTGGPGGMT
TGGPPPGGGTTTGGPGGMT
TGGPTTGGGGTGGPPGGMT
TGGPTTTGGGGGGGGGPMT
MMMPTTTTGGGGGGGPMMM
